44444444444444444444444444444444444444444444444444444444444444444444444444444444444444444
44444444444444444444444444444444444444444444444444444444444444444444444444444444444444444
44444444444444444444444444444444444444444444444444444444444444444444444444444444444444444
44444444444444444444444444444444444444444555554444444444444444444444444444444444444444444
44444444444444444444444444444444444444000000000000004444444446644444444444444444444444444
44444444444444445550000000000000000000000000000000000000000000000000000000004444444444444
44444444444440000000000000000000000000000000000000000000000000000000000000000004444444444
04444444400000000000000000000000000000000000000000000000000000000000000000000004444444444
00444400000000000000000000000000004444444400000004444400000000000000000000000000444444444
00444000000000000000444444444444444000440000000000000444445544440000000000000000044444444
00000000000004444444700000000000000004600000000000000000000000044444444000000000055444444
00000000000444000000000000000000000044000000000000000000000000000000044440000000000444444
P0000000444400000000000000000000000004400000000000000000000000000000000440000000004444444
00004444400000000000000000000000000000444000000000000000000000000000000440000000004444444
00004000000000000000000000000000000000074000000000000000000000000000006400000000006444444
00044000000000000000000000000000000000004400000000000000000000000000000440000000000444444
04447000000000004444400000000000000000000004600000000000000000000000000044400000000044444
04444000000000000005544444444444444000000004444400000000000000000000004444000000000044444
04447000000000000000000000000000004444440000000044444440000000000004444400000000000004444
44444000000000000000000000000000000000444440000000044444444444444460000000000000000044444
44446000000000000000000000000000000000000044744444444444000000000000000000000000000044444
44444000444445500000000000000000000000000000000000000000000000000000000000000000555444444
44444000004444444444444444440000000000000000000000000000000000000000000000004444444444444
44444000000000000000000000044444444444000000000000000000000000000044444444444444444444444
44444444400000000000000000004444444444444455555000000444444444444444444444444444444444444
44444444444444444466444444004444444444444444444444444444444444444444444444444444444444444
44444444444444444444444444408444444444444444444444444444444444444444444444444444444444444
44444444444444444444444444444444444444444444444444444444444444444444444444444444444444444
44444444444444444444444444444444444444444444444444444444444444444444444444444444444444444